###################
# #*#*#*#*#*#*#*#*#
#  . . . . . . . .#
#R#\#\#\#\#\#\#\#\L
#.#################
#.#
#.#
#.#
#.#
#.#
###
