#######################
#                     #
#                     #
#                     #
#                     #
#        ###***       #
#        #  ...       #
#       #L R####      #
#        ###          #
#                     #
#                     #
#                     #
#                     #
#                    \#
#######################
