#########
#     * #
#     #\L
#     ###
#       #
#       #
#       #
#       #
#       #
#       #
#       #
#R      #
#########
