#############
#    *#*    #
#    .#.    #
#   # # #   #
#   # R #   #
#   ##L##   #
#     #     #
#     #     #
#\\\\ #\\\\\#
#############
