#########
#       #
#       #
#  R \  # ####
#       # #\\L
#       # ####
#       #
#########
