#########
# @ @   #
#*   *  #
#       #
#       #
#  *    #
#  . R  L
#       #
#*   *###
##   ####
#########
